01000000000000000000000000000000000000000000000000000000000000000000000000000000000000000000000000000
02022202222222022222222202220222020222220222222222020222222202222222220222222222222222222222220202020
02020202020002000202000002000202020000020200020002020202020000000200020002000202000002000200000202020
02020222022202220202222202222202022202220202222202220202022202220202222202022202222202020202022202220
02000002000000000202020202000202020202000002000200000002020002000002000000000202000000020002020000020
02222222022222022202020222022202020222022222022222020202022222220202222222022202022222222222022222020
02000000000200020000020200000200020202000000020002020202000002000202000000000002020002000200000200020
02022222222222022222020202222222220202020222222202022222022222022202222222222222020222220222022222020
02020000020000000002000002000202020202020002000000000000020200020002000000020000000002020000020000020
02020222222202222202022202220202020202022222020202222202020202222202222222022222222222022222222222020
02000000000202000200020200000000000200000002020202000002000202020202000002000000000202020202000000020
02220222022222220202020202022222022202222222022222022202220222020222222202220202022202020202222222220
02020200000202020002020002000002000202000002000002020202000000000002000002000202000002020000020002000
02022222022202022222220202022222022202022222220222220222020222020222022222022222020222020222220222220
02000002000002000000020202000202020002020000020200000000020200020200000000000202020200000000000202000
02022202022222222202220222022202222222020222222222020222220222020222222202220202022202220202220202220
02020200020002020000000202000200020202000200000202020202020200020000000200020202000200020200020000020
02020222020202020222222202220202020202020202222202222202022222022202020202220202022222220222022222020
02020002000200020200000002020002020000020202020000000200020202020202020202000200000002020002000002000
02220202022202222222222202022222022202220202020202022202220202020202220202222222222222022222020202020
00020200020002000002000200000200000000020202000202000000000200000202000200020002000002020002020202020
02222222022222222202220202222202022202022202220202222222222202022202020202222202222202020222220222220
02000200000202000002000200000002020002000000020202000002000202020002020200000202000002000000000000020
02022202222202022202220222022222222202220202222202022222022222220202220202220202222202022222022222220
02000002000200020002020200000002020002000202000200000000020200000202000000020002000002000202000000020
02222222022202222222020202020222022202222202220202022222220202220222220202222222220222020202022202220
00020200000200020002000002020000020200000200020002020202000200020002020200020202000200020002000200020
02020222220202022202222202222222020222220222020222020202022222220222022202220202220222222222222222020
02020200000202000000020200020002000200000002020200020002000002000002000200020000000000020200000202020
02220222022202022222220202220222220222022202220222022202022202022202022202020222022222020202220202020
00020002000202020000020002000000000200020000020202000200020202020200000202000200020002020202000200020
02022202220202220222220202220222220222222222022202022222020202220202222202220222222202020222022202020
02000200000000020000020202000002020200020000000200000200020200000002020002020202000200000202000002020
02222222022202020222222222020222022202222222222222022202220202220222020202020202022222220202022222220
02000200000202020000020200020002000000020002020000020002000202000002000200020200000002020002000200000
02020202220222220222020222220202220202020222020222222202220202020222220202222222220222022202222222020
00020200020000020002000200000200020202020000020202000000020002020000020202020002020200000000020000020
02220202022222220222222222022202020222022202220202220222022222222202222202022202020222020222022202220
02020202020202000202000000020202020200020002000002000202020002020200020002000002020200020200020202000
02022202220202220202222202220222022222022202220222220202022202020222020202222202020222022222020222220
02000000000200020000000000000200020202000200000000000200000000000002020200000002020000000200020002000
02020202020202022202020202220222220202020222220222222222022222222202222222022202020202022202220202220
02020202020202000002020200020200000202020000000002000202000200000000000200020000020202000202020200020
02022202220222020222222202222202220202222202220222220202022222220222022222222202222222220222022222020
00020200020200020002000200020000020000020002000202000000000002000002020200020002000000000002000002000
02020222020222222202220202220222222202022202222202220202020202220202020202020202220222222222220202220
02020202020202000000000200020000020002000200020000000202020202020202000202020202000002020000000202020
02220202222202220222222222022202022222022202222222222202222202022222222222022202220222022222220222020
00000000000200020002000200020002020002000202020000000202000002000200020200020000020000000000020000020
02022222222202220222020202220222020202020202020202222202220202220222020222020202220202222222222202220
02000002020002020002020202020002020200020000020202020002000200000000020200000200020200020002000200020
02220202022202022222022222022222022222220222222202022202222222022202020222022222022222220222220202220
00020200020200020000000200000200020200000202020200000002000002000202020202020202000002020200020002020
02222222020222020222020222020222020202222202020222222202022222022202220202220202020222020222020202020
00020000000200000002020002020200020000020200000200020200000002020000000202000002020202000000000200000
02222222220222022222022202020222220202220222022222020222022222222222220202220222222202022222220222220
02000200000202000200000202020002020200020000020000000200020202000200000202000002000200020000000200020
02220222220202222202020222022202022202020222022222020202020202020222220202220222020202022202220202220
02000202000200000002020200020000000202020200000000020002020200020202000202020000020202020000020200000
02020202022202222202220202222222022222220202222202022222020202022202220202022222022222222222220222020
00020200020000020002000002000002000200000200000202000202020202000200020202020002020002020000000200020
02222222222202222222222222022222222222220222222222220202220222020202220202022202020202022222222222220
02000000020200020000000000000002000200020202000000020000000200020000020200000202000202020000020200000
02220202220202220202222202222222022222022202022222222202220202220222222202020202020222020222020222220
02020200000002000200000200000000000200000200000200020002000202020200000002020202020200020202000200000
02022222022222220202220222022222222202220202222222022202022222020222022222220202020222020202220202220
00020200020200000200020200000000000002020000020200000002000002000200000002020000020000020000020002000
02020202020222022202220202022222022202020202020222220202022222022222022222022222222202022202022222220
02020202000002020002020202020002000202000202020200020202000202000000020202020000000202020002000002000
02020222022222222202020222220202222202220202020202220222022202022222020202020222222222222202222202020
02000002000202020000020002020202000200020202000000020002000200020000020002000200000000000000000202020
02220222020202022222022222020222220202020222220222020222220222220222222202020222222222022202022222220
02000202020200000000020002020002000202020200000200020002000002000202000200020002000200020002020200020
02222202022202022222222202020222220202222222222202222202220202022202022222020222220222022202020222020
00020002000002000002020000000200000200020002000000020200020202020200020002020200000002020202020002000
02022202022222222202022202220222020222220202222202220202022222020202022202020202022222020222220222220
02020002020200000200020002020200020000020202000202000202000200020202020000020202020200000002020200020
02222202020202222222220222022202220222220222022202220222222222020202022202022222020222022222020202220
00020000000000000200000000000002000002020200000200000000000202000002000002000000020000000200000000020
02222202220222220222222222022222022222020222220222020222220202222222222222020202022202222222022202020
00020002000002000200000000000002000000000200000000020202000002020200000000020202000002000200020202000
02022202022202222202022202220202020222222202222222022202220202020222220202222202222222220222220222220
02020002000202000202020202000202020202000000020002000002020200000202020202000000020002000000000000020
02022222022222220202220222222222222202222222220222022222020222220202020222220222220202222222220202220
02020202000002020202000200020202000200000002020000020202000200000002000002000000000200000200000200020
02020202022202020202022222020202220222222202022222020202022222022222222202020222022202220202022222020
02020000000200000200000200000200000002000002020002020000020002020000000002020200000202020202000200020
02222222020202220202020222020222220222020202020222220202222202222222222202220202022222020222022222220
02000200020200020202020002020202000002020200020200000202020000000200000002000202000202000002000000000
02220222220222222222222202022202220222220222020222220222022202022202020222020222222202020222022222020
02000000000200020200020000020200000000020200000002020200000002020202020200020002020200020002020202020
02220202222202220202222202020222220222222222222202020222220222220222222222220222020222220202220202220
00000202020000020000020002000000020002020200020000020000020000020200000002000000000002000202020002020
02222222020222220202220202220222020222020202020222022202022222020202020202222202222222222222022202020
00020200000200000202000202020202000000000202020002000002020200020002020202000000020000000202000000020
02220222022222022222222202022202220222222222020202220222020222022222022202222222222202220202222202020
00020000020002000202000002020000000202000002020200020002020200020000000202020000020002020002020002020
02022202020202220202220202022222222202222202022222022222220202222222020202020222222222020222020222220
02020202020200020200000200020002020000000200020002000200000000020000020202000002000200000202020002020
02220202222202220222022222220222022202222222022202222222222202220222222222222202220202222202020222020
00000000000000000000000000000000000000000000000000000000000000000000000000000000000000000000000000030
